###########################################################################################################################################
#.........................................................................................................................................#
#.........................................................................................................................................#
#.........................................................................................................................................#
#.........................................................................................................................................#
#.........................................................................................................................................#
#.........................................................................................................................................#
#...............................############################..............................................................................#
#...............................############################..............................................................................#
#...............................############################..............................................................................#
#.........................................................................................................................................#
#.........................................................................................................................................#
#.........................................................................................................................................#
#.........................................................................................................................................#
#........Q................................................................................................................................#
#.........................................................................................................................................#
############################..............................................................................................................#
############################..............................................................................................................#
############################.........................................P.........................................................D..........#
###########################################################################################################################################