##########################################################################################
#........................................................................................#
#........................................................................................#
#......###...............................................................................#
#.....#...#.........#####................................................................#
#.....#...#..............................................................................#
#.....#...#..#####.......................................................................#
#.....#...#...............#####..........................................................#
#.....#...#..............................................................................#
#.....#...#..............................................................................#
#.....#...#.................E............................................................#
#.....#...#....####.......#####..........................................................#
#.....#...#...P..................R.......................................................#
##########################################################################################