####################################################################################################
#..................................................................................................#
#..................................................................................................#
#......###.........................................................................................#
#.....#...#.........#####..........................................................................#
#.....#...#........................................................................................#
#.....#...#..#####.................................................................................#
#.....#...#...............#####....................................................................#
#.....#...#.........E..............................................................................#
#.....#...#.......#####............................................................................#
#.....#...#.................C......................................................................#
#.....#...#...........................#####........................................................#
#.....#...#...P....................................................................................#
###############################################################.......................##############
###############################################################.......................##############
###############################################################.......................##############
###############################################################.......................##############
###############################################################.......................##############
###############################################################.......................##############
####################################################################################################